1
W W W W W W W W W W W W W W W W W W W
W S S S W W . . . . . . . . W G G G W
W S S S W BH . P . P . P . BH W G G G W
W S S S . . . . . . . . . . . G G G W
W S S S . BH . P . P . P . BH W W W W W
W S S S W W . . . . . . . . W W W W W
W W W W W W W W W W W W W W W W W W W
